7 68
                                                                    
      ////////                                               +++++++
      ////////       //////  //////   //////    //////       +++++++
      ////////       //////  //////   //////    //////       +++++++
      ////////       //////  //////   //////    //////       +++++++
                                                                    
   *******************************************************   +++++++