17 72
========================================================================
=        ********        +++++++++++++++++++++++++++++++++++++++++++   =
=        ********        +++++++++++++++++++++++++++++++++++++++++++   =
=        ***** **                                                      =
=        ***** **                                                      =
=        ***** **                                            +++++++   =
=                                                            +++++++   =
=                                                            +++++++   =
=                                                                      =
=     ////////                                               +++++++   =
=     ////////       //////  //////   //////    //////       +++++++   =
=     ////////       //////  //////   //////    //////       +++++++   =
=     ////////       //////  //////   //////    //////       +++++++   =
=                                                                      =
=  *******************************************************   +++++++   =
=  *******************************************************   +++++++   =
========================================================================